Name of the Event = blackberry	 Number of Occurence = 25
Name of the Event = narendramodi	 Number of Occurence = 18
Name of the Event = pm	 Number of Occurence = 17
Name of the Event = pakistan	 Number of Occurence = 13
Name of the Event = india	 Number of Occurence = 13
Name of the Event = sachintendulkar	 Number of Occurence = 12
Name of the Event = bjp	 Number of Occurence = 10
Name of the Event = torch	 Number of Occurence = 8
Name of the Event = vaio	 Number of Occurence = 8
Name of the Event = sony	 Number of Occurence = 8
Name of the Event = tendulkar	 Number of Occurence = 5
Name of the Event = rahuldravid	 Number of Occurence = 5
Name of the Event = odi	 Number of Occurence = 5
Name of the Event = modi	 Number of Occurence = 4
Name of the Event = cup	 Number of Occurence = 3
Name of the Event = retirement	 Number of Occurence = 3
Name of the Event = sachin	 Number of Occurence = 3
Name of the Event = dravid	 Number of Occurence = 3
Name of the Event = farewell	 Number of Occurence = 3
Name of the Event = fit	 Number of Occurence = 3
Name of the Event = rahul	 Number of Occurence = 3
Name of the Event = m14x	 Number of Occurence = 2
Name of the Event = gujarati	 Number of Occurence = 2
Name of the Event = faisalabad	 Number of Occurence = 2
Name of the Event = flip	 Number of Occurence = 2
Name of the Event = news	 Number of Occurence = 2
Name of the Event = shahbaz	 Number of Occurence = 2
Name of the Event = punjab	 Number of Occurence = 2
Name of the Event = tv9	 Number of Occurence = 2
Name of the Event = world	 Number of Occurence = 2
Name of the Event = primeminister	 Number of Occurence = 2
Name of the Event = candidate	 Number of Occurence = 2
Name of the Event = amitabhbachchan	 Number of Occurence = 2
Name of the Event = wankhede	 Number of Occurence = 2
Name of the Event = u19	 Number of Occurence = 2
Name of the Event = core	 Number of Occurence = 2
Name of the Event = curve	 Number of Occurence = 1
Name of the Event = rajthackeray	 Number of Occurence = 1
Name of the Event = hundred	 Number of Occurence = 1
Name of the Event = nz	 Number of Occurence = 1
Name of the Event = party	 Number of Occurence = 1
Name of the Event = bba	 Number of Occurence = 1
Name of the Event = abp	 Number of Occurence = 1
Name of the Event = bbc	 Number of Occurence = 1
Name of the Event = mohitkamboj	 Number of Occurence = 1
Name of the Event = alienware	 Number of Occurence = 1
Name of the Event = harshabhogle	 Number of Occurence = 1
Name of the Event = kaushambi	 Number of Occurence = 1
Name of the Event = lhc	 Number of Occurence = 1
Name of the Event = dell	 Number of Occurence = 1
Name of the Event = lok	 Number of Occurence = 1
Name of the Event = akhilesh	 Number of Occurence = 1
Name of the Event = shri	 Number of Occurence = 1
Name of the Event = sharif	 Number of Occurence = 1
Name of the Event = temple	 Number of Occurence = 1
Name of the Event = rob	 Number of Occurence = 1
Name of the Event = february	 Number of Occurence = 1
Name of the Event = touch	 Number of Occurence = 1
Name of the Event = advani	 Number of Occurence = 1
Name of the Event = series	 Number of Occurence = 1
Name of the Event = diary	 Number of Occurence = 1
Name of the Event = john	 Number of Occurence = 1
Name of the Event = faqsberrycom	 Number of Occurence = 1
Name of the Event = ahmedabad	 Number of Occurence = 1
Name of the Event = september	 Number of Occurence = 1
Name of the Event = aamirkhan	 Number of Occurence = 1
Name of the Event = ganguly	 Number of Occurence = 1
Name of the Event = computex	 Number of Occurence = 1
Name of the Event = x	 Number of Occurence = 1
Name of the Event = congress	 Number of Occurence = 1
Name of the Event = rajasthan	 Number of Occurence = 1
Name of the Event = narendra	 Number of Occurence = 1
Name of the Event = chennai	 Number of Occurence = 1
Name of the Event = hitler	 Number of Occurence = 1
Name of the Event = march	 Number of Occurence = 1
Name of the Event = lewis	 Number of Occurence = 1
Name of the Event = souravganguly	 Number of Occurence = 1
Name of the Event = mexico	 Number of Occurence = 1
Name of the Event = sabha	 Number of Occurence = 1
Name of the Event = pkg	 Number of Occurence = 1
Name of the Event = ana	 Number of Occurence = 1
Name of the Event = haryana	 Number of Occurence = 1
Name of the Event = december	 Number of Occurence = 1
Name of the Event = speech	 Number of Occurence = 1
Name of the Event = lk	 Number of Occurence = 1
Name of the Event = duo	 Number of Occurence = 1
Name of the Event = australia	 Number of Occurence = 1
Name of the Event = wall	 Number of Occurence = 1
Name of the Event = lahore	 Number of Occurence = 1
Name of the Event = delhi	 Number of Occurence = 1
Name of the Event = asia	 Number of Occurence = 1
Name of the Event = odis	 Number of Occurence = 1
Name of the Event = university	 Number of Occurence = 1
Name of the Event = inch	 Number of Occurence = 1
Name of the Event = indian	 Number of Occurence = 1
Name of the Event = general	 Number of Occurence = 1
Name of the Event = election	 Number of Occurence = 1
Name of the Event = hothardware	 Number of Occurence = 1
Name of the Event = first	 Number of Occurence = 1
